M M M M M M M M M M M M M M M M M M M M M M M M M M M M M M M M M M M M M M M M M M
M M M M M M M M M M M M M M M M M M M M M M M M M M M M M M M M M M M M M M M M M M
M M M M M M M M M M M M M M M M M M M M M M M M M M M M M M M M M M M M M M M M M M
M M M R R R R R R R R R R M R R R R P P R P R P R R R R R R M R R R R R R R R M M M
M M M R P P P R P R P R R B R R P R R R R P R P R P P P R R B R R R R R R S R M M M
M M M R R R R R P R P R R M R R P R P P R R R R R P R R R R M R R R R R R R R M M M
M M M R P P M M M M M M M M M M M M M M M M M M M M M M M M M M M M M M M M M M M M
M M M R P R M M M M M M M M M M M M M M M M M M M M M M M M M M M M M M M M M M M M
M M M R P R R P R R R R R R M R R R R R P R P R R R R M R R R R R P R R P R R M M M
M M M R P R R P R P P P R R B R R P R R P R P P P R R B R R P R R P R R P P R M M M
M M M R R R R R R R R P R R M R R P R R R R R R P R R M R R P R R R R R R R R M M M
M M M M M M M M M M M M M M M M M M M M M M M M M M M M M M M M M M M M R P R M M M
M M M M M M M M M M M M M M M M M M M M M M M M M M M M M M M M M M M M R R R M M M
M M M M M M M M M M M M M M M M M M M M M M M M M M M M M M M M M M M M M B M M M M
M M M M M M M M M M M M M M M M M M M M M M M M M M M M M M M M M M M M R R R M M M
M M M M M M M M M M M M M M M M M M M M M M M M M M M M M M M M M M M M R R R M M M
M M M R R R R P R M R R P R R R R R P R R R R R P R R R R M R R R R P P R P R M M M
M M M R R R R P R B R P P R R P R R P R P P R R P R P P R B R R P R R P R P R M M M
M M M P P R R R R M R R R R R P R R R R R P R R R R R R R M R R P R R R R R R M M M
M M M R R R M M M M M M M M M M M M M M M M M M M M M M M M M M M M M M M M M M M M
M M M P P R M M M M M M M M M M M M M M M M M M M M M M M M M M M M M M M M M M M M
M M M R R R M M M M M M M M M M M M M M M M M M M M M M M M M M M M M M M M M M M M
M M M R P R M M M M M M M M M M M M M M M M M M M M M M M M M M M M M M M M M M M M
M M M R P R R R R M R R R R R P R R R R R R R P R R M R R R P R R P R R R R R M M M
M M M R P P R P R B R R P P R P P P R P P P R P P R B R P R P P R P R P R R R M M M
M M M R R R R P R M R R R R R R R P R P R R R R R R M R R R R R R R R P P P R M M M
M M M M M M M M M M M M M M M M M M M M M M M M M M M M M M M M M M M M R R R M M M
M M M M M M M M M M M M M M M M M M M M M M M M M M M M M M M M M M M M P P R M M M
M M M M M M M M M M M M M M M M M M M M M M M M M M M M M M M M M M M M R R R M M M
M M M M M M M M M M M M M M M M M M M M M M M M M M M M M M M M M M M M P P R M M M
M M M R R R R P R R R R P R R R R M R R R R R R R P P P R R R P R M R P R P R M M M
M M M P P P R P R P R R P R P P R B R R P R P P R P R R R R R P R B R P R P R M M M
M M M R R R R R R P R R R R R R R M R R P R R P R P R R P P R R R M R R R R R M M M
M M M R P P M M M M M M M M M M M M M M M M M M M M M M M M M M M M M M M M M M M M
M M M R R R M M M M M M M M M M M M M M M M M M M M M M M M M M M M M M M M M M M M
M M M R P P M M M M M M M M M M M M M M M M M M M M M M M M M M M M M M M M M M M M
M M M R R P R R R R R R P R R R P R R P R M R R R R R R P R R R R R R R R R R M M M
M M M R R P P P R P R R P R R P P P R P R B R P R P P R P R P R R P R R R G R M M M
M M M R R R R R R P R R R R R R R R R P R M R P R R R R R R R R R P R R R R R M M M
M M M M M M M M M M M M M M M M M M M M M M M M M M M M M M M M M M M M M M M M M M
M M M M M M M M M M M M M M M M M M M M M M M M M M M M M M M M M M M M M M M M M M
M M M M M M M M M M M M M M M M M M M M M M M M M M M M M M M M M M M M M M M M M M
