M M M M M M M M M M M M M M M M M M M M M M M M M M M M M M M M M M M M M M M M M M
M M M M M M M M M M M M M M M M M M M M M M M M M M M M M M M M M M M M M M M M M M
M M M M M M M M M M M M M M M M M M M M M M M M M M M M M M M M M M M M M M M M M M
M M M P P P P P P P P P P M P P R R P P R P R P R R R R R R M R R R R R R R R M M M
M M M P P P P P P P P P P B P P P R R R R P R P R P P P R R B R R R R R R S R M M M
M M M P P P P P P P P P P M P P P R P P R R R R R P R R R R M R R R R R R R R M M M
M M M P P P M M M M M M M M M M M M M M M M M M M M M M M M M M M M M M M M M M M M
M M M P P P M M M M M M M M M M M M M M M M M M M M M M M M M M M M M M M M M M M M
M M M P P P P P P P P P P P M P P P P P P P P P P P P M P P P P P P P P P P P M M M
M M M P P P P P P P P P P P B P P P P P P P P P P P P B P P P P P P P P P P P M M M
M M M P P P P P P P P P P P M P P P P P P P P P P P P M P P P P P P P P P P P M M M
M M M M M M M M M M M M M M M M M M M M M M M M M M M M M M M M M M M M P P P M M M
M M M M M M M M M M M M M M M M M M M M M M M M M M M M M M M M M M M M P P P M M M
M M M M M M M M M M M M M M M M M M M M M M M M M M M M M M M M M M M M M B M M M M
M M M M M M M M M M M M M M M M M M M M M M M M M M M M M M M M M M M M P P P M M M
M M M M M M M M M M M M M M M M M M M M M M M M M M M M M M M M M M M M P P P M M M
M M M P P P P P P M P P P P P P P P P P P P P P P P P P P M P P P P P P P P P M M M
M M M P P P P P P B P P P P P P P P P P P P P P P P P P P B P P P P P P P P P M M M
M M M P P P P P P M P P P P P P P P P P P P P P P P P P P M P P P P P P P P P M M M
M M M P P P M M M M M M M M M M M M M M M M M M M M M M M M M M M M M M M M M M M M
M M M P P P M M M M M M M M M M M M M M M M M M M M M M M M M M M M M M M M M M M M
M M M P P P M M M M M M M M M M M M M M M M M M M M M M M M M M M M M M M M M M M M
M M M P P P M M M M M M M M M M M M M M M M M M M M M M M M M M M M M M M M M M M M
M M M P P P P P P M P P P P P P P P P P P P P P P P M P P P P P P P P P P P P M M M
M M M P P P P P P B P P P P P P P P P P P P P P P P B P P P P P P P P P P P P M M M
M M M P P P P P P M P P P P P P P P P P P P P P P P M P P P P P P P P P P P P M M M
M M M M M M M M M M M M M M M M M M M M M M M M M M M M M M M M M M M M P P P M M M
M M M M M M M M M M M M M M M M M M M M M M M M M M M M M M M M M M M M P P P M M M
M M M M M M M M M M M M M M M M M M M M M M M M M M M M M M M M M M M M P P P M M M
M M M M M M M M M M M M M M M M M M M M M M M M M M M M M M M M M M M M P P P M M M
M M M P P P P P P P P P P P P M P P P P P P P P P P P P P P P P P M P P P P P M M M
M M M P P P P P P P P P P P P B P P P P P P P P P P P P P P P P P B P P P P P M M M
M M M P P P P P P P P P P P P M P P P P P P P P P P P P P P P P P M P P P P P M M M
M M M P P P M M M M M M M M M M M M M M M M M M M M M M M M M M M M M M M M M M M M
M M M P P P M M M M M M M M M M M M M M M M M M M M M M M M M M M M M M M M M M M M
M M M P P P M M M M M M M M M M M M M M M M M M M M M M M M M M M M M M M M M M M M
M M M P P P P P P P P P P P P P P P P M P P P P P P P P P P P P P P P P P P P M M M
M M M P P P P P P P P P P P P P P P P B P P P P P P P P P P P P P P P P P G P M M M
M M M P P P P P P P P P P P P P P P P M P P P P P P P P P P P P P P P P P P P M M M
M M M M M M M M M M M M M M M M M M M M M M M M M M M M M M M M M M M M M M M M M M
M M M M M M M M M M M M M M M M M M M M M M M M M M M M M M M M M M M M M M M M M M
M M M M M M M M M M M M M M M M M M M M M M M M M M M M M M M M M M M M M M M M M M