200 200 200 200 200 200 200 200 200 200 200 200 200 200 200 200 200 200 200 200 200 200 200 200 200 200 200 200 200 200 200 200 200 200 200 200 200 200 200 200 200 200
200 200 200 200 200 200 200 200 200 200 200 200 200 200 200 200 200 200 200 200 200 200 200 200 200 200 200 200 200 200 200 200 200 200 200 200 200 200 200 200 200 200
200 200 200 200 200 200 200 200 200 200 200 200 200 200 200 200 200 200 200 200 200 200 200 200 200 200 200 200 200 200 200 200 200 200 200 200 200 200 200 200 200 200
200 200 200 1 1 1 1 1 1 1 1 1 1 200 1 1 5 5 1 1 5 1 5 1 5 5 5 5 5 5 200 5 5 5 5 5 5 5 5 200 200 200
200 200 200 1 1 1 1 1 1 1 1 1 1 5 1 1 1 5 5 5 5 1 5 1 5 1 1 1 5 5 5 5 5 5 5 5 5 4 5 200 200 200
200 200 200 1 1 1 1 1 1 1 1 1 1 200 1 1 1 5 1 1 5 5 5 5 5 1 5 5 5 5 200 5 5 5 5 5 5 5 5 200 200 200
200 200 200 1 1 1 200 200 200 200 200 200 200 200 200 200 200 200 200 200 200 200 200 200 200 200 200 200 200 200 200 200 200 200 200 200 200 200 200 200 200 200
200 200 200 1 1 1 200 200 200 200 200 200 200 200 200 200 200 200 200 200 200 200 200 200 200 200 200 200 200 200 200 200 200 200 200 200 200 200 200 200 200 200
200 200 200 1 1 1 1 1 1 1 1 1 1 1 200 1 1 1 1 1 1 1 1 1 1 1 1 200 1 1 1 1 1 1 1 1 1 1 1 200 200 200
200 200 200 1 1 1 1 1 1 1 1 1 1 1 5 1 1 1 1 1 1 1 1 1 1 1 1 5 1 1 1 1 1 1 1 1 1 1 1 200 200 200
200 200 200 1 1 1 1 1 1 1 1 1 1 1 200 1 1 1 1 1 1 1 1 1 1 1 1 200 1 1 1 1 1 1 1 1 1 1 1 200 200 200
200 200 200 200 200 200 200 200 200 200 200 200 200 200 200 200 200 200 200 200 200 200 200 200 200 200 200 200 200 200 200 200 200 200 200 200 1 1 1 200 200 200
200 200 200 200 200 200 200 200 200 200 200 200 200 200 200 200 200 200 200 200 200 200 200 200 200 200 200 200 200 200 200 200 200 200 200 200 1 1 1 200 200 200
200 200 200 200 200 200 200 200 200 200 200 200 200 200 200 200 200 200 200 200 200 200 200 200 200 200 200 200 200 200 200 200 200 200 200 200 200 5 200 200 200 200
200 200 200 200 200 200 200 200 200 200 200 200 200 200 200 200 200 200 200 200 200 200 200 200 200 200 200 200 200 200 200 200 200 200 200 200 1 1 1 200 200 200
200 200 200 200 200 200 200 200 200 200 200 200 200 200 200 200 200 200 200 200 200 200 200 200 200 200 200 200 200 200 200 200 200 200 200 200 1 1 1 200 200 200
200 200 200 1 1 1 1 1 1 200 1 1 1 1 1 1 1 1 1 1 1 1 1 1 1 1 1 1 1 200 1 1 1 1 1 1 1 1 1 200 200 200
200 200 200 1 1 1 1 1 1 5 1 1 1 1 1 1 1 1 1 1 1 1 1 1 1 1 1 1 1 5 1 1 1 1 1 1 1 1 1 200 200 200
200 200 200 1 1 1 1 1 1 200 1 1 1 1 1 1 1 1 1 1 1 1 1 1 1 1 1 1 1 200 1 1 1 1 1 1 1 1 1 200 200 200
200 200 200 1 1 1 200 200 200 200 200 200 200 200 200 200 200 200 200 200 200 200 200 200 200 200 200 200 200 200 200 200 200 200 200 200 200 200 200 200 200 200
200 200 200 1 1 1 200 200 200 200 200 200 200 200 200 200 200 200 200 200 200 200 200 200 200 200 200 200 200 200 200 200 200 200 200 200 200 200 200 200 200 200
200 200 200 1 1 1 200 200 200 200 200 200 200 200 200 200 200 200 200 200 200 200 200 200 200 200 200 200 200 200 200 200 200 200 200 200 200 200 200 200 200 200
200 200 200 1 1 1 200 200 200 200 200 200 200 200 200 200 200 200 200 200 200 200 200 200 200 200 200 200 200 200 200 200 200 200 200 200 200 200 200 200 200 200
200 200 200 1 1 1 1 1 1 200 1 1 1 1 1 1 1 1 1 1 1 1 1 1 1 1 200 1 1 1 1 1 1 1 1 1 1 1 1 200 200 200
200 200 200 1 1 1 1 1 1 5 1 1 1 1 1 1 1 1 1 1 1 1 1 1 1 1 5 1 1 1 1 1 1 1 1 1 1 1 1 200 200 200
200 200 200 1 1 1 1 1 1 200 1 1 1 1 1 1 1 1 1 1 1 1 1 1 1 1 200 1 1 1 1 1 1 1 1 1 1 1 1 200 200 200
200 200 200 200 200 200 200 200 200 200 200 200 200 200 200 200 200 200 200 200 200 200 200 200 200 200 200 200 200 200 200 200 200 200 200 200 1 1 1 200 200 200
200 200 200 200 200 200 200 200 200 200 200 200 200 200 200 200 200 200 200 200 200 200 200 200 200 200 200 200 200 200 200 200 200 200 200 200 1 1 1 200 200 200
200 200 200 200 200 200 200 200 200 200 200 200 200 200 200 200 200 200 200 200 200 200 200 200 200 200 200 200 200 200 200 200 200 200 200 200 1 1 1 200 200 200
200 200 200 200 200 200 200 200 200 200 200 200 200 200 200 200 200 200 200 200 200 200 200 200 200 200 200 200 200 200 200 200 200 200 200 200 1 1 1 200 200 200
200 200 200 1 1 1 1 1 1 1 1 1 1 1 1 200 1 1 1 1 1 1 1 1 1 1 1 1 1 1 1 1 1 200 1 1 1 1 1 200 200 200
200 200 200 1 1 1 1 1 1 1 1 1 1 1 1 5 1 1 1 1 1 1 1 1 1 1 1 1 1 1 1 1 1 5 1 1 1 1 1 200 200 200
200 200 200 1 1 1 1 1 1 1 1 1 1 1 1 200 1 1 1 1 1 1 1 1 1 1 1 1 1 1 1 1 1 200 1 1 1 1 1 200 200 200
200 200 200 1 1 1 200 200 200 200 200 200 200 200 200 200 200 200 200 200 200 200 200 200 200 200 200 200 200 200 200 200 200 200 200 200 200 200 200 200 200 200
200 200 200 1 1 1 200 200 200 200 200 200 200 200 200 200 200 200 200 200 200 200 200 200 200 200 200 200 200 200 200 200 200 200 200 200 200 200 200 200 200 200
200 200 200 1 1 1 200 200 200 200 200 200 200 200 200 200 200 200 200 200 200 200 200 200 200 200 200 200 200 200 200 200 200 200 200 200 200 200 200 200 200 200
200 200 200 1 1 1 1 1 1 1 1 1 1 1 1 1 1 1 1 200 1 1 1 1 1 1 1 1 1 1 1 1 1 1 1 1 1 1 1 200 200 200
200 200 200 1 1 1 1 1 1 1 1 1 1 1 1 1 1 1 1 5 1 1 1 1 1 1 1 1 1 1 1 1 1 1 1 1 6 1 1 200 200 200
200 200 200 1 1 1 1 1 1 1 1 1 1 1 1 1 1 1 1 200 1 1 1 1 1 1 1 1 1 1 1 1 1 1 1 1 1 1 1 200 200 200
200 200 200 200 200 200 200 200 200 200 200 200 200 200 200 200 200 200 200 200 200 200 200 200 200 200 200 200 200 200 200 200 200 200 200 200 200 200 200 200 200 200
200 200 200 200 200 200 200 200 200 200 200 200 200 200 200 200 200 200 200 200 200 200 200 200 200 200 200 200 200 200 200 200 200 200 200 200 200 200 200 200 200 200
200 200 200 200 200 200 200 200 200 200 200 200 200 200 200 200 200 200 200 200 200 200 200 200 200 200 200 200 200 200 200 200 200 200 200 200 200 200 200 200 200 200